#############################################################
#                                                           #
#          #     #   ######   #       #       #####         #
#          #     #   #        #       #       #   #         #
#    @     #######   ####     #       #       #   #         #
#          #     #   #        #       #       #   #         #
#          #     #   ######   #####   #####   #####         #
#                                                           #
#                                                           #
#    #       #   #####   ####    #       ####    #  #  #    #
#    #       #   #   #   #   #   #       #   #   #  #  #    #
#     #  #  #    #   #   ####    #       #   #   #  #  #    #
#     # # # #    #   #   #  #    #       #   #              #
#      #   #     #####   #   #   #####   ####    #  #  #    #
#                                                           #
#############################################################