#############################################################
#                                                           #
#          #    #   ######   #       #        ###           #
#          #    #   #        #       #       #   #          #
#    @     ######   ####     #       #       #   #          #
#          #    #   #        #       #       #   #          #
#          #    #   ######   #####   #####    ###           #
#                                                           #
#                                                           #
#    #       #    ###    ####    #       ####    #  #  #    #
#    #       #   #   #   #   #   #       #   #   #  #  #    #
#     #  #  #    #   #   ####    #       #   #   #  #  #    #
#     # # # #    #   #   #  #    #       #   #              #
#      #   #      ###    #   #   #####   ####    #  #  #    #
#                                                           #
#############################################################